1111111111100
10010C0000111
1000011110001
1P0011E000001
1111111111111
