1111111111100
10010C0000111
1P00000000000
100011E000001
1111111111111
