1111111111100
10010C1000111
1000011111001
1P0011E000001
1111111111111
