1111111111111
10010000100C1
1001000000001
1111000000001
100000P000001
100011E000101
1111111111111
