1111111111111
1001000010001
1001000000001
1111000000001
100000P000001
1000110000101
1111111111111
