1111111111111
10010000100C1
10P0000000001
100011E000101
1111111111111
